NO ./texture/NO.xpm
SO ./texture/SO.xpm
WE ./texture/WE.xpm
EA ./texture/EA.xpm

F 0,0,0
C 190,130,0

        111111111111111111111111111
        101100000111000000000000001
        100100000000000000000000001
11111111101100000111000000000000111
100000000011000001110111111111111
11110111111111011100000010001001
1111011111111101110101010001011
11000000110101011100000000001
10000000000000001100000010001
10000000000000001101010010001
1100000111010101111101111000111
10110111 1100101 1011110100S1
11111111 1111111 111111111111
